BBBBBBBBBBBB
B---------XB
BB-C------BB
BBBBBP---BBB
BBBBB-BBBBBB
BBBB-C-----B
B-C----BBBBB
BX--------XB
BBBBBBBBBBBB