BBBBBBBBBBBB
B--P---BBBBB
B---C--BBBBB
B--------BBB
B-BB-BBBBBBB
B---------XB
BBBBBC-----B
BX-----BBBBB
BBBBBBBBBBBB