BBBBBBBBBBBB
B----------B
BB-C------BB
BBBBBPBBBBBB
BBBBB-BBBBBB
B----------B
B-C---BBBBBB
BX--------XB
BBBBBBBBBBBB