BBBBBBBBBBBB
BX-P-------B
B-------C--B
BBBBB-BBBBBB
BBBBB----BBB
BBBBBC--C-XB
BBBX---BBBBB
BBBB-------B
BBBBBBBBBBBB