BBBBBBBBBBBB
BBBBBB----XB
BX------P--B
BBBBBB--BBBB
B----------B
B--C----BBBB
B-------C--B
BBBBBB-----B
BBBBBBBBBBBB