BBBBBBBBBBBB
B-PBBBBBBBBB
BB--BBBBBBBB
BBB--C--XBBB
BBBBB-BBBBBB
BB-BB-BBBBBB
BB----BBBBBB
B--C-----XBB
BBBBBBBBBBBB